MemoryTest
An Interactive Fiction by Steve Lacy
Release 1 / Serial number 131021 / Inform 7 build 6G60 (I6/v6.32 lib 6/12N) SD

A small, starkly furnished room.
You awake slowly, and as you come to consciousness, you feel as though you've awaken in a strange and different place, but it seems somewhat familiar.

There's a comfortable looking chair beside your bed.

You can also see your bed and a nightstand (on which is a picture) here.

>look
Your room
You can see a picture here.

>look at picture
You see nothing special about the picture.

* * *

MemoryTest
An Interactive Fiction by Steve Lacy
Release 1 / Serial number 131021 / Inform 7 build 6G60 (I6/v6.32 lib 6/12N) SD

A small, starkly furnished room.
You awake slowly, and as you come to consciousness, you feel as though you've awaken in a strange and different place, but it seems somewhat familiar.

There's a comfortable looking chair beside your bed.

You can also see your bed and a nightstand (on which is a picture) here.

>look at bed
You see nothing special about your bed.

>look at nightstand
On the nightstand is a picture.

>look at picture
You see nothing special about the picture.

* * *

MemoryTest
An Interactive Fiction by Steve Lacy
Release 1 / Serial number 131021 / Inform 7 build 6G60 (I6/v6.32 lib 6/12N) SD

A small, starkly furnished room.
You awake slowly, and as you come to consciousness, you feel as though you've awaken in a strange and different place, but it seems somewhat familiar.

There's a comfortable looking chair beside your bed.

You can also see your bed and a nightstand (on which is a picture) here.

>look at picture
It's a beautiful picture of two young people on the beach.  The woman is wearing a long, flowing white gown, and holding a small bouquet.  The man is wearing a tuxedo.  They appear to be kissing.

Ah, now I remember!

>help
That's not a verb I recognise.

* * *

>look at picture
It's a beautiful picture of two young people on the beach.  The woman is wearing a long, flowing white gown, and holding a small bouquet.  The man is wearing a tuxedo.  They appear to be kissing.

Ah, now I remember!

>inventory
You are carrying:
  a picture

* * *

>look at picture
It's a beautiful picture of two young people on the beach.  The woman is wearing a long, flowing white gown, and holding a small bouquet.  The man is wearing a tuxedo.  They appear to be kissing.

Ah, now I remember!

>look
Your room
You awake slowly, and as you come to consciousness, you're reminded again of how frail you've become.

You can see your bed, a nightstand (on which is a wedding picture (in which is a memory getting married)) and a chair here.

* * *

>look at picture
It's a beautiful picture of two young people on the beach.  The woman is wearing a long, flowing white gown, and holding a small bouquet.  The man is wearing a tuxedo.  They appear to be kissing.

Ah, now I remember!

>remember
What do you want to remember?

>remember getting married
getting married

>look
A small, starkly furnished room.
You awake slowly, and as you come to consciousness, you feel as though you've awaken in a strange and new place, but it seems somewhat familiar.

There's a comfortable looking chair beside your bed.

You can also see your bed and a nightstand (on which is a picture) here.

>look at picture
A picture of your marriage on the beach.

Ah, now I remember!

* * *

>look at picture
It's a beautiful picture of two young people on the beach.  The woman is wearing a long, flowing white gown, and holding a small bouquet.  The man is wearing a tuxedo.  They appear to be kissing.

Ah, now I remember!

>look at picture
A picture of your marriage on the beach.

>look at picture
A picture of your marriage on the beach.

>look at self
As good-looking as ever.

>look at me
As good-looking as ever.

>look at player
You can't see any such thing.

* * *

>look at picture
A picture of your marriage on the beach.

>remember getting married
getting married

>strengthen
That's not a verb I recognize.

>strengthen getting married
That's not a verb I recognize.

>look
A small, starkly furnished room.
You awake slowly, and as you come to consciousness, you feel as though you've awaken in a strange and new place, but it seems somewhat familiar.

There's a comfortable looking chair beside your bed.

You can also see your bed and a nightstand (on which is a picture) here.

>look at bed
You see nothing special about your bed.

* * *

>look at nightstand
On the nightstand is a picture.

>look at picture
A picture of your marriage on the beach.

* * *

>look at picture
It's a beautiful picture of two young people on the beach.  The woman is wearing a long, flowing white gown, and holding a small bouquet.  The man is wearing a tuxedo.  They appear to be kissing.

Ah, now I remember!

>remember getting married
getting married

>remember
You must supply a noun.

* * *

>remember getting married
getting married

>remember your son
You can't see any such thing.

>remember alice
You can't see any such thing.

* * *

MemoryTest
An Interactive Fiction by Steve Lacy
Release 1 / Serial number 131021 / Inform 7 build 6G60 (I6/v6.32 lib 6/12N) SD

A small, starkly furnished room.
You awake slowly, and as you come to consciousness, you feel as though you've awaken in a strange and different place, but it seems somewhat familiar.

There's a comfortable looking chair beside your bed.

You can also see your bed and a nightstand (on which is a picture) here.

>look picture
It's a beautiful picture of two young people on the beach.  The woman is wearing a long, flowing white gown, and holding a small bouquet.  The man is wearing a tuxedo.  They appear to be kissing.

Ah, now I remember!

>inventory
You are carrying:
  getting married

>look getting married
You see nothing special about getting married.

* * *

>inventory
You are carrying:
  getting married

>memories
That's not a verb I recognise.

* * *

>look picture
It's a beautiful picture of two young people on the beach.  The woman is wearing a long, flowing white gown, and holding a small bouquet.  The man is wearing a tuxedo.  They appear to be kissing.

Ah, now I remember!

>remember
Yes, it's all clear now.

>thoughts
That's not a verb I recognise.

>think
What a good idea.

>think about
Yes, it's all clear now.

* * *

MemoryTest
An Interactive Fiction by Steve Lacy
Release 1 / Serial number 131021 / Inform 7 build 6G60 (I6/v6.32 lib 6/12N) SD

A small, starkly furnished room.
You awake slowly, and as you come to consciousness, you feel as though you've awaken in a strange and different place, but it seems somewhat familiar.

There's a comfortable looking chair beside your bed.

You can also see your bed and a nightstand (on which is a picture) here.

>take your firstborn son
You can't see any such thing.

>look
Your room
You awake slowly, and as you come to consciousness, you're reminded again of how frail you've become.

You can see your bed, a nightstand (on which is a picture) and a chair here.

>look
Your room
You awake slowly, and as you come to consciousness, you're reminded again of how frail you've become.

You can see your bed, a nightstand (on which is a picture) and a chair here.

* * *

MemoryTest
An Interactive Fiction by Steve Lacy
Release 1 / Serial number 131021 / Inform 7 build 6G60 (I6/v6.32 lib 6/12N) SD

A small, starkly furnished room.
You awake slowly, and as you come to consciousness, you feel as though you've awaken in a strange and different place, but it seems somewhat familiar.

There's a comfortable looking chair beside your bed.

You can also see your bed and a nightstand (on which is a picture) here.

>look at wedding picture
It's a beautiful picture of two people kissing on the beach.  The woman is wearing a long, flowing white gown, and holding a small bouquet.  The man is wearing a tuxedo.

Ah, now I remember!

>remember
That's not a verb I recognise.

>remember
That's not a verb I recognise.

* * *

MemoryTest
An Interactive Fiction by Steve Lacy
Release 1 / Serial number 131021 / Inform 7 build 6G60 (I6/v6.32 lib 6/12N) SD

A small, starkly furnished room.
You awake slowly, and as you come to consciousness, you feel as though you've awaken in a strange and different place, but it seems somewhat familiar.

There's a comfortable looking chair beside your bed.

You can also see your bed and a nightstand (on which is a picture) here.

>look nightstand
You see nothing special about the nightstand.

* * *

MemoryTest
An Interactive Fiction by Steve Lacy
Release 1 / Serial number 131021 / Inform 7 build 6G60 (I6/v6.32 lib 6/12N) SD

A small, starkly furnished room.
You awake slowly, and as you come to consciousness, you feel as though you've awaken in a strange and different place, but it seems somewhat familiar.

There's a comfortable looking chair beside your bed.

You can also see your bed and a nightstand (on which is a picture) here.

>look at nightstand
On the nightstand is a picture.

>look at picture
It's a beautiful picture of two people kissing on the beach.  The woman is wearing a long, flowing white gown, and holding a small bouquet.  The man is wearing a tuxedo.

Ah, now I remember!

* * *

MemoryTest
An Interactive Fiction by Steve Lacy
Release 1 / Serial number 131021 / Inform 7 build 6G60 (I6/v6.32 lib 6/12N) SD

A small, starkly furnished room.
You awake slowly, and as you come to consciousness, you feel as though you've awaken in a strange and different place, but it seems somewhat familiar.

There's a comfortable looking chair beside your bed.

You can also see your bed and a nightstand (on which is a picture) here.

>remember
nothing

>remembering
That's not a verb I recognise.

>remember getting married
That's not a verb I recognise.

* * *

>remembering
That's not a verb I recognise.

>remember
Yes, it's all clear now.

>remember getting married
I only understood you as far as wanting to remember.

>remember your wife
I only understood you as far as wanting to remember.

* * *

>remember
nothing

>remember the chair
That's not a verb I recognise.

* * *

>remember
nothing

>remember the picture
That's not a verb I recognise.

* * *

>remember
nothing

>look at picture
It's a beautiful picture of two young people on the beach.  The woman is wearing a long, flowing white gown, and holding a small bouquet.  The man is wearing a tuxedo.  They appear to be kissing.

Ah, now I remember!

>remember
Yes, it's all clear now.
 getting married

>inventory
You are carrying nothing.

* * *

>remember
nothing

>look at the picture
It's a beautiful picture of two young people on the beach.  The woman is wearing a long, flowing white gown, and holding a small bouquet.  The man is wearing a tuxedo.  They appear to be kissing.

Ah, now I remember!

>remember
Yes, it's all clear now.
 getting married

* * *

>remember
nothing

>remember getting married
I only understood you as far as wanting to remember.

>remembering getting married
That's not a verb I recognize.

>look at picture
It's a beautiful picture of two young people on the beach.  The woman is wearing a long, flowing white gown, and holding a small bouquet.  The man is wearing a tuxedo.  They appear to be kissing.

Ah, now I remember!

>remember
You must supply a noun.

>remember getting married
I only understood you as far as wanting to remember.

>remember your marriage
I only understood you as far as wanting to remember.

>think about
You must supply a noun.

>think about getting married
I only understood you as far as wanting to think about.

* * *

>remember getting married
I only understood you as far as wanting to remember.

>remember
nothing

>remember something
I only understood you as far as wanting to remember.

>remember
nothing

* * *

MemoryTest
An Interactive Fiction by Steve Lacy
Release 1 / Serial number 131021 / Inform 7 build 6G60 (I6/v6.32 lib 6/12N) SD

A small, starkly furnished room.
You awake slowly, and as you come to consciousness, you feel as though you've awaken in a strange and different place, but it seems somewhat familiar.

There's a comfortable looking chair beside your bed.

You can also see your bed and a nightstand (on which is a picture) here.

>think about
Yes, it's all clear now.

>remember
Yes, it's all clear now.

>think
What a good idea.

* * *

>think about
Yes, it's all clear now.

I beg your pardon?

I beg your pardon?

* * *

MemoryTest
An Interactive Fiction by Steve Lacy
Release 1 / Serial number 131021 / Inform 7 build 6G60 (I6/v6.32 lib 6/12N) SD

A small, starkly furnished room.
You awake slowly, and as you come to consciousness, you feel as though you've awaken in a strange and different place, but it seems somewhat familiar.

There's a comfortable looking chair beside your bed.

You can also see your bed and a nightstand (on which is a picture) here.

I beg your pardon?

* * *

MemoryTest
An Interactive Fiction by Steve Lacy
Release 1 / Serial number 131021 / Inform 7 build 6G60 (I6/v6.32 lib 6/12N) SD

A small, starkly furnished room.
You awake slowly, and as you come to consciousness, you feel as though you've awaken in a strange and different place, but it seems somewhat familiar.

There's a comfortable looking chair beside your bed.

You can also see your bed and a nightstand (on which is a picture) here.

>remember getting married
You can't just pull memories out of thin air.

getting married

>look at picture
It's a beautiful picture of two young people on the beach.  The woman is wearing a long, flowing white gown, and holding a small bouquet.  The man is wearing a tuxedo.  They appear to be kissing.

Ah, now I remember!

>remember getting married
I only understood you as far as wanting to remember.

* * *

>remember getting married
You can't just pull memories out of thin air.

getting married

>he remembers
That's not a verb I recognize.

>look
A small, starkly furnished room.
You awake slowly, and as you come to consciousness, you feel as though you've awaken in a strange and new place, but it seems somewhat familiar.

There's a comfortable looking chair beside your bed.

You can also see your bed and a nightstand (on which is a picture) here.

>look at self
As good-looking as ever.

* * *

>look at me
As good-looking as ever.

>look at picture
It's a beautiful picture of two young people on the beach.  The woman is wearing a long, flowing white gown, and holding a small bouquet.  The man is wearing a tuxedo.  They appear to be kissing.

Ah, now I remember!

>look at me
As good-looking as ever.

>do I remember
That's not a verb I recognize.

* * *

>remember getting married
You can't just pull memories out of thin air.

getting married

>memorybank
That's not a verb I recognize.

>remember
That's not a verb I recognize.

* * *

MemoryTest
An Interactive Fiction by Steve Lacy
Release 1 / Serial number 131021 / Inform 7 build 6G60 (I6/v6.32 lib 6/12N) SD

A small, starkly furnished room.
You awake slowly, and as you come to consciousness, you feel as though you've awaken in a strange and different place, but it seems somewhat familiar.

There's a comfortable looking chair beside your bed.

You can also see your bed and a nightstand (on which is a picture) here.

>remember getting married
I only understood you as far as wanting to remember.

>remember
You must supply a noun.

>remember your son
I only understood you as far as wanting to remember.

>remember married
I only understood you as far as wanting to remember.

* * *

MemoryTest
An Interactive Fiction by Steve Lacy
Release 1 / Serial number 131021 / Inform 7 build 6G60 (I6/v6.32 lib 6/12N) SD

A small, starkly furnished room.
You awake slowly, and as you come to consciousness, you feel as though you've awaken in a strange and different place, but it seems somewhat familiar.

There's a comfortable looking chair beside your bed.

You can also see your bed and a nightstand (on which is a picture) here.

>remember foo
You can't see any such thing.

>remember getting married
You don't remember that.

>remember narb
You can't see any such thing.

>remember your son
You can't see any such thing.

>look picture
It's a beautiful picture of two young people on the beach.  The woman is wearing a long, flowing white gown, and holding a small bouquet.  The man is wearing a tuxedo.  They appear to be kissing.

Ah, now I remember!

>remember getting married
getting married

* * *

>remember getting married
You don't remember that.

>look at picture
It's a beautiful picture of two young people on the beach.  The woman is wearing a long, flowing white gown, and holding a small bouquet.  The man is wearing a tuxedo.  They appear to be kissing.

Ah, now I remember!

* * *

MemoryTest
An Interactive Fiction by Steve Lacy
Release 1 / Serial number 131021 / Inform 7 build 6G60 (I6/v6.32 lib 6/12N) SD

A small, starkly furnished room.
You awake slowly, and as you come to consciousness, you feel as though you've awaken in a strange and different place, but it seems somewhat familiar.

There's a comfortable looking chair beside your bed.

You can also see your bed and a nightstand (on which is a picture) here.

>remember me
You don't remember that.

>remember something
You can't see any such thing.

>remember anything
You can't see any such thing.

>look at picture
It's a beautiful picture of two young people on the beach.  The woman is wearing a long, flowing white gown, and holding a small bouquet.  The man is wearing a tuxedo.  They appear to be kissing.

Ah, now I remember!

* * *

MemoryTest
An Interactive Fiction by Steve Lacy
Release 1 / Serial number 131021 / Inform 7 build 6G60 (I6/v6.32 lib 6/12N) SD

A small, starkly furnished room.
You awake slowly, and as you come to consciousness, you feel as though you've awaken in a strange and different place, but it seems somewhat familiar.

There's a comfortable looking chair beside your bed.

You can also see your bed and a nightstand (on which is a picture) here.

>remember blarg
You can't see any such thing.

* * *

MemoryTest
An Interactive Fiction by Steve Lacy
Release 1 / Serial number 131021 / Inform 7 build 6G60 (I6/v6.32 lib 6/12N) SD

A small, starkly furnished room.
You awake slowly, and as you come to consciousness, you feel as though you've awaken in a strange and different place, but it seems somewhat familiar.

There's a comfortable looking chair beside your bed.

You can also see your bed and a nightstand (on which is a picture) here.

>forget who
You can't see any such thing.

>forget getting married
You can't forget something you don't know.

>remember getting married
You don't remember "getting married".

* * *

MemoryTest
An Interactive Fiction by Steve Lacy
Release 1 / Serial number 131021 / Inform 7 build 6G60 (I6/v6.32 lib 6/12N) SD

A small, starkly furnished room.
You awake slowly, and as you come to consciousness, you feel as though you've awaken in a strange and different place, but it seems somewhat familiar.

There's a comfortable looking chair beside your bed.

You can also see your bed and a nightstand (on which is a picture) here.

>strengthen getting married
Ah, now I remember!

>strengthening
That's not a verb I recognize.

>strengthen
That's not a verb I recognize.