Steve's Blog
An Interactive Fiction by Steve Lacy
Release 1 / Serial number 131017 / Inform 7 build 6G60 (I6/v6.32 lib 6/12N) SD

Welcome
Hi, Steve here.

I've been recentely fascinated by the idea(s) of Interactive Fiction, and am embarking on learning how to write for IF systems, specifically Inform7.  To that end, I've decided to document the process as a blog.  An Interactive blog, and this is my first post.

Interactive Fiction? A Blog?  Can these things be combined?  I'm not sure, so here I am documenting the process.

The question is: Can a blog be written in the form of interactive fiction?  What would it look like?  Would anyone read it?  How does navigation work?

Use the verbs up/down to navigate between posts.  The newest post is always at the top, so use "down" to go to previous posts.

You can also see a blank note here.

>look
Welcome
This is my first post.

Interactive Fiction? A Blog?  Can these things be combined?  I'm not sure, so here I am documenting the process. 

The question is: Can I write a blog in the form of interactive fiction?  What would it look like?  Would anyone read it?  How does navigation work?

So, I've decided that in addition to needing how to write Interactive Fiction (IF) using Inform7, I also should document that process, so I've decided to document the process using Inform7 itself, and in the form of a blog-like "story" as it were.

>?
That's not a verb I recognise.

* * *

>look
Welcome
This is my first post.

Interactive Fiction? A Blog?  Can these things be combined?  I'm not sure, so here I am documenting the process. 

The question is: Can I write a blog in the form of interactive fiction?  What would it look like?  Would anyone read it?  How does navigation work?

So, I've decided that in addition to needing how to write Interactive Fiction (IF) using Inform7, I also should document that process, so I've decided to document the process using Inform7 itself, and in the form of a blog-like "story" as it were.

>take execution
Taken.

>look
Welcome
Hello world

The question is: Can I write a blog in the form of interactive fiction?  What would it look like?  Would anyone read it?  How does navigation work?

>take interactive
Taken.

>look
Welcome
Hello world

>inventory
You are carrying:
  interactive blog
  execution

>drop execution
Dropped.

>look
Welcome
Hello world

You can see execution here.

>look
Welcome
Hello world

You can see execution here.

* * *

>look
Welcome
This is my first post.

Interactive Fiction? A Blog?  Can these things be combined?  I'm not sure, so here I am documenting the process. 

The question is: Can I write a blog in the form of interactive fiction?  What would it look like?  Would anyone read it?  How does navigation work?

So, I've decided that in addition to needing how to write Interactive Fiction (IF) using Inform7, I also should document that process, so I've decided to document the process using Inform7 itself, and in the form of a blog-like "story" as it were.

>look
Welcome
Hello world

The question is: Can I write a blog in the form of interactive fiction?  What would it look like?  Would anyone read it?  How does navigation work?

So, I've decided that in addition to needing how to write Interactive Fiction (IF) using Inform7, I also should document that process, so I've decided to document the process using Inform7 itself, and in the form of a blog-like "story" as it were.

* * *

>look
Welcome
This is my first post.

Interactive Fiction? A Blog?  Can these things be combined?  I'm not sure, so here I am documenting the process. 

The question is: Can I write a blog in the form of interactive fiction?  What would it look like?  Would anyone read it?  How does navigation work?

So, I've decided that in addition to needing how to write Interactive Fiction (IF) using Inform7, I also should document that process, so I've decided to document the process using Inform7 itself, and in the form of a blog-like "story" as it were.

>look interactive
You see nothing special about interactive.

>look execution
You see nothing special about execution.

* * *

>look
Welcome
This is my first post.

Interactive Fiction? A Blog?  Can these things be combined?  I'm not sure, so here I am documenting the process. 

The question is: Can I write a blog in the form of interactive fiction?  What would it look like?  Would anyone read it?  How does navigation work?

So, I've decided that in addition to needing how to write Interactive Fiction (IF) using Inform7, I also should document that process, so I've decided to document the process using Inform7 itself, and in the form of a blog-like "story" as it were.

>north
Second
This is just the next post, I haven't actually written it yet.

>look
Second
This is just the next post, I haven't actually written it yet.

>south
Welcome
This is my first post.

Interactive Fiction? A Blog?  Can these things be combined?  I'm not sure, so here I am documenting the process. 

The question is: Can I write a blog in the form of interactive fiction?  What would it look like?  Would anyone read it?  How does navigation work?

So, I've decided that in addition to needing how to write Interactive Fiction (IF) using Inform7, I also should document that process, so I've decided to document the process using Inform7 itself, and in the form of a blog-like "story" as it were.

>clear
What do you want to clear?

>next
You can't see any such thing.

* * *

>leek
That's not a verb I recognise.

>look
Welcome
Hello world

The question is: Can I write a blog in the form of interactive fiction?  What would it look like?  Would anyone read it?  How does navigation work?

* * *

>take execution
That's fixed in place.

>take interactive
That's fixed in place.

* * *

>down
Second
This is just the next post, I haven't actually written it yet.

You can see a good idea here.

>up
Welcome
This is my first post.

Interactive Fiction? A Blog?  Can these things be combined?  I'm not sure, so here I am documenting the process. 

The question is: Can I write a blog in the form of interactive fiction?  What would it look like?  Would anyone read it?  How does navigation work?

So, I've decided that in addition to needing how to write Interactive Fiction (IF) using Inform7, I also should document that process, so I've decided to document the process using Inform7 itself, and in the form of a blog-like "story" as it were.

Use the verbs up/down to navigate between posts.  The newest post is always at the top, so use "down" to go to previous posts.

* * *

>down
Second
This is just the next post, I haven't actually written it yet.

You can see a good idea here.

>look at good idea
You see nothing special about the good idea.

>take good idea
Taken.

>look
Second
This is just the next post, I haven't actually written it yet.

>up
Welcome
Hi, Steve here.

I've been recentely fascinated by the idea(s) of Interactive Fiction, and am embarking on learning how to write for IF systems, specifically Inform7.  To that end, I've decided to document the process as a blog.  An Interactive blog, and this is my first post.

Interactive Fiction? A Blog?  Can these things be combined?  I'm not sure, so here I am documenting the process.

The question is: Can a blog be written in the form of interactive fiction?  What would it look like?  Would anyone read it?  How does navigation work?

Use the verbs up/down to navigate between posts.  The newest post is always at the top, so use "down" to go to previous posts.

You can also see a blank note here.

>drop good idea
Dropped.

>look
Welcome
Hi, Steve here.

I've been recentely fascinated by the idea(s) of Interactive Fiction, and am embarking on learning how to write for IF systems, specifically Inform7.  To that end, I've decided to document the process as a blog.  An Interactive blog, and this is my first post.

Interactive Fiction? A Blog?  Can these things be combined?  I'm not sure, so here I am documenting the process.

The question is: Can a blog be written in the form of interactive fiction?  What would it look like?  Would anyone read it?  How does navigation work?

Use the verbs up/down to navigate between posts.  The newest post is always at the top, so use "down" to go to previous posts.

You can also see a good idea and a blank note here.

* * *

>look notext
You see nothing special about notext.

* * *

>take navigation
That's fixed in place.

>look
Welcome
Hi, Steve here.

I've been recentely fascinated by the idea(s) of Interactive Fiction, and am embarking on learning how to write for IF systems, specifically Inform7.  To that end, I've decided to document the process as a blog.  An Interactive blog, and this is my first post.

Interactive Fiction? A Blog?  Can these things be combined?  I'm not sure, so here I am documenting the process.

The question is: Can a blog be written in the form of interactive fiction?  What would it look like?  Would anyone read it?  How does navigation work?

Use the verbs up/down to navigate between posts.  The newest post is always at the top, so use "down" to go to previous posts.

You can also see notext here.

>take interactive
That's fixed in place.

>look notext
You see nothing special about notext.

* * *

>look at note
You see nothing special about the blank note.

>look at blank
You see nothing special about the blank note.

>down
Second
This is just the next post, I haven't actually written it yet.

>down
You can't go that way.

>up
Welcome
Hi, Steve here.

I've been recentely fascinated by the idea(s) of Interactive Fiction, and am embarking on learning how to write for IF systems, specifically Inform7.  To that end, I've decided to document the process as a blog.  An Interactive blog, and this is my first post.

Interactive Fiction? A Blog?  Can these things be combined?  I'm not sure, so here I am documenting the process.

The question is: Can a blog be written in the form of interactive fiction?  What would it look like?  Would anyone read it?  How does navigation work?

Use the verbs up/down to navigate between posts.  The newest post is always at the top, so use "down" to go to previous posts.

You can also see a blank note here.

>down
Second
This is just the next post, I haven't actually written it yet.